
NO ./Textures/no_texture.xpm
SO ./Textures/so_texture.xpm
WE ./Textures/we_texture.xpm
EA ./Textures/ea_texture.xpm

F 119,178,84
C 104,87,82


            11111111111111111111111111111111
            100N0000000000000000000000000001
            10000000010000000000000111111011
        111100000000000000000100100000111011
            11000100001100100000000001101011
            11111111111111100000000000000011111
        1111000000000000000000000000000000000001111
            11111111111111111111111111111111111
