11111111111111111111111111111111
10000000000000000000000000000001
10000000111101110011110000000001
10000000000000000000000000010001
10000111111000000000000100000001
10000000001000000000000100010001
10001111111000000000000100000001
10000000000000000000000100000001
11111111111000000011111111111111
