
NO ./Textures/no_texture.xpm
SO ./Textures/so_texture.xpm
WE ./Textures/we_texture.xpm
EA ./Textures/ea_texture.xpm

F 220,100,0
C 50,90,20


      11111111111111111    
    110000000000000000011
  1100000000000000000000011
 1000000000000000000000001
 1000000000000000000000001
  11100000000000000000011
    1000000000000000001
     11111111001111111
            1001
            1001
    11111111100111111    
  110000000000000000011
1100000000000000000000011
1000000000000000000000001
10000000000N0000000000001
 11100000000000000000011
    1000000000000000001
     11111111001111111
     1111111111111111