
NO ./Textures/no_texture.xpm
SO ./Textures/so_texture.xpm
WE ./Textures/we_texture.xpm
EA ./Textures/ea_texture.xpm

F 220,100,0
C 225,30,55

1111111111111111111111111111111111111111
1000000000000000000000000000000000000001
10N0001000000000000000000000000000000001
1000000101000000000000000000000000000001
1010010010100000000000000000000000000001
1000000100010000000000000000000000000001
1111111111111111111111111111111111111111