111111
10E101
1010W1
111111

111111
110SN1
111111