



        1111111111111111111111111
        1000000000110000000000001
        1011000001110000000000001
        10010000000000000000000001
111111111111111111111111111111111

111111111111111111111111111111111
111111111011000001110000000000001
100000000011000001110111111111111
11110111111111011100000010001
11110111111111011101010010001
11000000110101011100000010001
1000000000000W001100000010001
1000000000000001101010010001
110000011101010111110111100011111111111
11110111 1011101 101111010001
11111111 1110111 111111111111