
NO ./Textures/no_texture.xpm
SO ./Textures/so_texture.xpm
WE ./Textures/we_texture.xpm
EA ./Textures/ea_texture.xpm

F 220,100,0
C 225,30,55

11111111111111
10000000000001
10N00000000001
10000000010001
10100100101001
10000001000101
11111111111111