NO ./Textures/bricks/bricks-no.xpm
SO ./Textures/bricks/bricks-so.xpm
EA ./Textures/bricks/bricks-ea.xpm
WE ./Textures/bricks/bricks-we.xpm


F 220,100,0
C 225,30,55


1111111111111111111111111111111111111111111
1000000000000000000000000000000000000000001
1000000000000000000101010000000000000000001
1000000000000000000000000000000000000000001
1000000000000000000000000000000000000000001
1000000000000000000000000000000000000000001
1000010000000000000000000000000000000000001
1000000000000000000000000000000000000001001
100001000000000000000W000000000000000000001
1000000000000000000000000000000000000001001
1000010000000000000000000000000000000000001
1000010000000000000000000000000000000000001
1000000000000000000000000000000000000000001
1000000000000000000000000000000000000000001
1000000000000000000000000000000000000000001
1000000000000000000001000000000000000000001
1000000000000000000000000000000000000000001
1111111111111111111111111111111111111111111