1111111111111111
10000000000P0001
1000000000000001
1000000000000001
1000000000000001
1100000000010001
1111111111111111