11111111111
10000000001
10000P00001
10000000001
11000000001
11111111111