11111111111
10000000001
10000P00001
11000000011
11111111111