11111111
10000001
100P0001
10001001
11111111