11111111111111111
10100001000010001
10111101111011101
10100001000011101
10111101111011101
10100001000011101
11111111111111111
