NO ./path_to_the_north_texture
SO ./path_to_the_south_texture
WE ./path_to_the_west_texture
EA ./path_to_the_east_texture

F 220,100,0
C 225,30,55

111111111111111111
100000000000000001
11111111111111111111111111111111111111

        1111111111
        1000000001
111111111000000001
100000000000000001
100000000000000001
1W0000000000000001
111111111111111101
               101
               101
        1111111101
        1111111101
111111111000000001
10001100000000001
1111 111111111111
1111  11111111111
