
NO ./Textures/no_texture.xpm
SO ./Textures/so_texture.xpm
WE ./Textures/we_texture.xpm
EA ./Textures/ea_texture.xpm

F 220,100,0
C 225,30,55

    111111    
   10000001   
  10000E0001  
 10001110001  
  100000001   
   1111111    
