
NO ./Textures/no_texture.xpm
SO ./Textures/so_texture.xpm
WE ./Textures/we_texture.xpm
EA ./Textures/ea_texture.xpm

F 220,100,0
C 225,30,55

11111111111111
10000000000  
11111111110111
111101111101  11
110001  10E01 10111
111101111111111
11111111111