
NO                                              ./path_to_the_north_texture

SO         ./path_to_the_south_texture

WE ./path_to_the_west_texture
EA ./path_to_the_east_texture

F 220,100,0
C 225,30,55

            1111111111111
        111100000000000001111
    11110000000000000000000001111
1111000000000000000000000000000001111                                        1   
111100000000000000W00000000000000111111111111111111111111                   101
1111000000000000000000000000000001111
    11110000000000000000000001111
        111100000000000001111
            1111111111111