NO ./path_to_the_north_texture
SO ./path_to_the_south_texture
WE ./path_to_the_west_texture
EA ./path_to_the_east_texture

F 220,100,0
C 225,30,55

1111111111111111111111111111111111111111111111111111111111111111
1000000000000000000000000000000000000000000000000000000000000001
1111111111111111111111111111111111111111111111111111111111111111

        11111111111111111111111111111111111111111111111111111111
        10000000000000000000000000000000000000000000000000000001
1111111110000000000000000000000000000000000000000000000000000001
1000000000000000000000000000000000000000000000000000000000000001
1000000000000000000000000000000000000000000000000000000000000001
1W00000000000000000000000000000000000000000000000000000000000001
1111111111111111000000000000000000000000000000000000000000000001
               1000000000000000000000000000000000000000000000001
               1000000000000000000000000000000000000000000000001
        11111111000000000000000000000000000000000000000000000001
        11111111000000000000000000000000000000000000000000000001
1111111110000000000000000000000000000000000000000000000000000001
1000110000000000000000000000000000000000000000000000000000000001
1000110000000000000000000000000000000000000000000000000000000001
1000110000000000000000000000000000000000000000000000000000000001
1000110000000000000000000000000000000000000000000000000000000001
1000110000000000000000000000000000000000000000000000000000000001
1000110000000000000000000000000000000000000000000000000000000001
1000110000000000000000000000000000000000000000000000000000000001
1000110000000000000000000000000000000000000000000000000000000001
1000110000000000000000000000000000000000000000000000000000000001
1000110000000000000000000000000000000000000000000000000000000001
1000110000000000000000000000000000000000000000000000000000000001
1000110000000000000000000000000000000000000000000000000000000001
1000110000000000000000000000000000000000000000000000000000000001
1111 11111111111111111111111111111111111111111111111111111111111
1111  11111111111
