
NO                                              ./path_to_the_north_texture

SO         ./path_to_the_south_texture

WE ./path_to_the_west_texture
EA ./path_to_the_east_texture

F 220,100,0
C 225,30,55

11111111111
10000000001
11111111111
11 101  1111
11  E   1111
11 101 1111
11111111111