NO                       ./textures/birds/1.xpm
SO ./textures/birds/2.xpm
WE ./textures/birds/3.xpm
EA ./textures/birds/4.xpm
                           
C 2,130,255
F 180,64,+100

        1111111111111111111111111
        1000000000110000000000001
        1011000001110000000000001
        1001000000000000000000001
111111111111111111111111111111111

111111111111111111111111111111111
111111111011000001110000000000001
100000000011000001110111111111111
11110111111111011100000010001
11110111111111011101010010001
11000000110101W11100000010001
10000000000000001100000010001
1000000000000001101010010001
110000011101010111110111100011111111111
11110111 101111 101111010001
11111111 111111 111111111111
