NO ./Textures/no_texture.xpm
SO ./Textures/so_texture.xpm
WE ./Textures/we_texture.xpm
EA ./Textures/ea_texture.xpm

F 220,100,0
C 225,30,0

        1111111111111111111111111
        1000000000110000000000001
        10110000011100000000000011111                 
        10010000000000000000000011101                  1  
        11111111111111111111111111111

        1111111111111111111111111
111111111011000001110000000000001
100000000011000001110111111111111
11110111111111011100000010001
11110111111111011101010010001
11000000110101011100000010001
10000000000000101100000010001
10000000000000001101010011111
11000001110101011111011110N0111
11110111 1110101 101111011111
11111111 1111111 111111111111