NO ./maps/map3/art-no.xpm
SO ./maps/map3/art-so.xpm
EA ./maps/map3/art-ea.xpm
WE ./maps/map3/art-we.xpm

F 12,12,12
C 152,216,239

1111111111
1100001001
1000S00001
1000001001
1111111111