NO ./maps/map7/bricks-no.xpm
SO ./maps/map7/bricks-so.xpm
EA ./maps/map7/bricks-ea.xpm
WE ./maps/map7/bricks-we.xpm

F 16,7,8
C 27,77,199

        1111111111111111111111111
        1000001000110000000000001
        1011001001110000000000001
        1001001000000000000000001
111111111011001001110000000000001
100000000011000001110000000011111
11110111111111011100000010001
11110111111111011101010010001
11000000110101011100000010001
10000000000110001100000000001
1000000000000100001010010001
110000011101N101111101111000111
11110111 1110101 101111010001
11111111 1110111 111111111111
        1111011111111111111111111
        1000000000110000000000001
        1011000001110000000000001
        1001000000000000000000001
111111111011000001110000000000001
100000000011000001110111111111111
11110111111111011100000010001
11110111111111011101010010001
11000000110101011100000010001
10000000000000001100000000001
10000000000000000001010010001
110000011101010111101111000111
11110111 1110101 101111010001
11111111 1111111 111111111111