NO ./maps/map1/funny-no..xpm
SO ./maps/map1/funny-so.xpm
EA ./maps/map1/funny-ea.xpm
WE ./maps/map1/funny-we.xpm


C 58,109,140
F 66,244,89 


        1111111111111111111
    111100000000000000000011111
1111000000100000000100000000001
10000100000100001000001000000101
10001000100001000001000001000001
1N010000000000000000001000000001
1000010000000000000001000000001
10000100000100001000001000000101
1111000000100000000100000000001
10001000100001000001000001000001
1111111111111111111111111111111