
                                    NO                      ./maps/map1/funny-no.xpm
SO ./maps/map1/funny-so.xpm
EA                      ./maps/map1/funny-ea.xpm
                    WE ./maps/map1/funny-we.xpm


F 66,244,89
            C                    58,109,140


        1111111111111111111
    1111000000000000000000111111111
11110000001000000001000000000001
10000100000100001000001000000101111
100010001000010000010000010000011111111111111111
1N0100000000000000000010000000011111111111 
10000100000000000000001000000001111111
1000010000010000100000100000000000000111
111100000010000000000010000000111111111
10001000100001000001001000000001
111111111111111111111111111111111
